11111111111111111111111111111111111111111111111111
10000000000000000000000000000000000000000000000001
10001100001100000000000000000000001111110000000001
10000110011000000000000000000000001100011000000001
10000011110000000000000000000000001100001100000001
10000001100000000000000000000000001100001100000001
10000110110000000000000000000000001100001100000001
10001100011000000000000000000000001100011000000001
10011000001100000000000000000000001111100000000001
10000000000000000000000000000000000000000000000001
10000000000000000000000000000000000000000000000001
10000000000000000000000000000000000000000000000001
10000000000000000000000000000000000000000000000001
10000001111000000000011111110000000000011110000001
10000011111100000000011111110000000000111111000001
10000110000000000000011000000000000001100000000001
10000011000000000000011000000000000011000000000001
10000001100000000000011111100000000011000000000001
10000000110000000000011111100000000011000000000001
10000000011000000000011000000000000011000000000001
10000000001100000000011000000000000011000000000001
10000000000110000000011000000000000001100000000001
10000011111100000000011111110000000000111111000001
10000001111000000000011111110000000000011110000001
10000000000000000000000000000000000000000000000001
10000000000000000000000000000000000000000000000001
10000000000000000000000000000000000000000000000001
11111111111111111111111111111111111111111111111111